Amsterdam = Netherlands
Andorra la Vella = Andorra
Ankara = Turkey
Athens = Greece
Beirut = Lebanon
Belgrade = Serbia
Berlin = Germany
Bern = Switzerland
Bratislava = Slovakia
Brussels = Belgium
Bucharest = Romania
Budapest = Hungary
Copenhagen = Denmark
Damascus = Syria
Dublin = Ireland
Helsinki = Finland
Jerusalem = Israel
Lisbon = Portugal
Ljubljana = Slovenia
London = United Kingdom
Luxembourg = Luxembourg
Madrid = Spain
Monaco = Monaco
Oslo = Norway
Paris = France
Podgorica = Montenegro
Prague = Czech Republic
Pristina = Kosovo
Riga = Latvia
Rome = Italy
San Marino = San Marino
Sarajevo = Bosnia and Herzegovina
Skopje = Macedonia
Sofia = Bulgaria
Stockholm = Sweden
Tallinn = Estonia
Tirana = Albania
Vaduz = Liechtenstein
Vatican City = Vatican City
Vienna = Austria
Vilnius = Lithuania
Warsaw = Poland
Yerevan = Armenia
Zagreb = Croatia